##################################################
##################################################
##################################################
#################################################T
##########T######################################L
#########LBR#####################################Y
##T###TTLUUURT##############FJC#GGTGGTGTGGTG#T#T#Y
BBBBBBBBUUUUURWWWWWWWWLBBBBBBBBBBBBBBBBBBBBBBBBBBU
UUUUUUUUUUUUUUBBBBBBBBUUUUUUUUUUUUUUUUUUUUUUUUUUUU