B#########################BBBB####################
BBBBBBBBBBBBBBBBBBBBBBBBBBB##BBBBBBBBBB###########
B#################################################
##########B####################BB################B
BBBBBB#BBBBBBBBBBBBBBBBBBBBBBBBBBBBBBBB###########
#####BBB##########################################
###########################################B######
##########################################B#B#####
BBBBBBBBBBBBBBBBBBBBBBBBBBBBBBBBBBBBBBBBBBBBBBBBBB