##########################BBBB####################
BBBBBBBBBBBBBBBBBBBBBBBBBBB##BBBBBBBBBB###########
B#################################################
###############################B#################B
BBBBBB#BBBBBBBBBBBBBBBBBBBBBBBBBBBBBBBB#B#########
##########################################B#######
########################################B#########
##########################################B#######
########################################B#########
BBBBBBBBBBBBBBBBBBBBBBBBBBBBBBBBBBBBBBBBBBBBBBBBBB