##########################BBBB####################
BBBBBBBBBBBBBBBBBBBBBBBBBBB##BBBBBBBBBB###########
B#################################################
###############################BB################B
BBBBBB#BBBBBBBBBBBBBBBBBBBBBBBBBBBBBBBB#B#########
##########################################B#######
########################################B#########
##########################################B#######
BBBBBBBBBBBBBBBBBBBBB###################B#########
BBBBBBBBBBBBBBBBBBBBBBBBBB###BBBBBBBBBBBBBBBBBBBBB
##################################################
BBBBBBBBBBBBBBBBBBBBBBBBBBB##BBBBBBBBBB###########
B#################################################
###############################B#################B
BBBBBB#BBBBBBBBBBBBBBBBBBBBBBBBBBBBBBBB#B#########
##########################################B#######
########################################B#########
##########################################B#######
########################################B#########
BBBBBBBBBBBBBBBBBBBBBBBBBB###BBBBBBBBBBBBBBBBBBBBB